111111111111111111111111111111111111111
100000000000000000000000000000000000001
1001CCCC1001111110001CCCC10011CCC100001
1001CCCC100CCCC1C0001CCCC1001C1CC100001
1001CCCC100CCC1CC0001CCCC1001CC1C100001
1001CCCC100CC1CCC0001CCCC1001CCC1100001
10011111100111111000111111001CCCC100001
100000000000000000000000000000000000001
1001CC1CC1CC1CC1CC1CC1CC1CC1CC1CC1CC101
100011011011011011011011011011011011001
1P00001001001001001001001001001001E0001
111111111111111111111111111111111111111
