1111111111111111111111111111111111
1000000000000000000000000000000001
101CCCC100111111001CCCC10011CCC101
101CCCC100CCCC1C001CCCC1001C1CC101
101CCCC100CCC1CC001CCCC1001CC1C101
101CCCC100CC1CCC001CCCC1001CCC1101
101111110011111100111111001CCCC101
1000000000000000000000000000000001
101CC1CC1CC1CC1CCCC1CC1CC1CC1CC101
1001101101101101111011011011011001
1P0001011001001001001001001001E001
1111111111111111111111111111111111
