1111111111111
1E10000000001
1010011111P01
10C011C100001
1111111111111
