1111111111111
10101000000P1
1010100111001
1000100000001
1110E01010101
1C00111C10001
1111111111111
