111111111111111111111111
1P1010000100001111111111
1010111100C0100111111111
101000E00001001000000001
10C010100001100000000001
111111111111111111111111