11111111111111111111
1CCCC0000CCCC0000001
1CCCC0000CCCC0000001
1CCCC0000CCCC0000001
1CCCC0000CCCC0000001
10000CCCC0000CCCC001
10000CCCC0000CCCC001
10000CCCC0000CCCC001
10000CCCC0000CCCC001
100000000CCCC0000001
100000000CCCC0000001
100000000CCCC0000001
100000000CCCC0000001
10000CCCCC0000000001
10000CCCCC0000000PE1
11111111111111111111
