11111111111111111111
1CCCC0000CCCC0000001
1CCCC0000CCCC0000001
1CCCC0000CCCC0000001
1CCCC0000CCCC0000001
10000CCCC0000CCCC001
10000CCCC0000CCCC001
10000CCCC0000CCCC001
10000CCCC0000CCCC001
10000000000000000001
10000000000000000001
10000000000000000001
1cccc000000000000001
1cccc000000000000001
1ccc0000000000000PE1
11111111111111111111
