11111111111111111111111111111111111111111111111
1000000000000000000000001CCCCC000000000000000E1
1000000000000000000CC00010000000000000000000001
10000000000000000000000010000000000000000000001
10000000000000000000000010000011111110000000001
10000000000000000000000010000000000000000000001
10000000000000000000000010000000000000000000001
10000011111111111111000010000000000000000000001
10000000000000000000000010000000000000000000101
1000000000CCCCCCCCC000001000CCC0000000000000101
1P0000000000000000000000100000000000000000001C1
11111111111111111111111111111111111111111111111
